{
  "id": "tropical-v1",
  "schemaVersion": 1,
  "tileWidth": 128,
  "tileHeight": 64,
  "width": 24,
  "height": 20,
  "origin": { "x": 1536, "y": 96 },
  "terrainLegend": {
    "w": "terrain/water",
    "s": "terrain/sand",
    "g": "terrain/grass",
    "j": "terrain/jungle",
    "r": "terrain/reef",
    "s+": "terrain/sand-detail",
    "g+": "terrain/grass-detail"
  },
  "rows": [
    ["w", "w", "w", "w", "w", "w", "w", "r", "r", "s", "s", "s", "s", "s", "r", "r", "w", "w", "w", "w", "w", "w", "w", "w"],
    ["w", "w", "w", "w", "w", "r", "s", "s", "s", "g", "g", "g", "g", "s", "s", "s", "r", "w", "w", "w", "w", "w", "w", "w"],
    ["w", "w", "w", "w", "r", "s", "s", "g", "g", "g", "j", "j", "g", "g", "g", "s", "s", "r", "w", "w", "w", "w", "w", "w"],
    ["w", "w", "w", "r", "s", "s", "g", "g", "g+", "g", "j", "j", "g", "g", "g", "s", "s", "s", "r", "w", "w", "w", "w", "w"],
    ["w", "w", "r", "s", "s", "g", "g", "g+", "g", "g", "j", "j", "g", "g", "g", "g", "s", "s", "s", "r", "w", "w", "w", "w"],
    ["w", "r", "s", "s", "g", "g", "g", "g", "g", "s+", "s", "s", "g", "g", "g", "g", "g", "s", "s", "r", "w", "w", "w", "w"],
    ["w", "r", "s", "g", "g", "j", "g", "g", "s", "s", "s", "s", "s", "g", "g", "j", "g", "g", "s", "s", "r", "w", "w", "w"],
    ["w", "r", "s", "g", "j", "j", "g", "g", "s", "s", "s", "s", "s", "g", "g", "j", "j", "g", "g", "s", "r", "w", "w", "w"],
    ["w", "r", "s", "g", "g", "j", "g", "g", "g", "s", "s", "s", "g", "g", "g", "g", "j", "g", "g", "s", "r", "w", "w", "w"],
    ["w", "w", "r", "s", "g", "g", "g", "g", "g", "g", "s", "s", "g", "g", "g", "g", "g", "g", "s", "r", "w", "w", "w", "w"],
    ["w", "w", "r", "s", "s", "g", "g", "g", "g", "g", "g", "g", "g", "g", "g", "g", "g", "s", "s", "r", "w", "w", "w", "w"],
    ["w", "w", "w", "r", "s", "s", "g", "g", "j", "g", "g", "g", "g", "g", "j", "g", "s", "s", "r", "w", "w", "w", "w", "w"],
    ["w", "w", "w", "r", "s", "s", "g", "j", "j", "g", "g", "g", "g", "j", "j", "g", "s", "s", "r", "w", "w", "w", "w", "w"],
    ["w", "w", "w", "w", "r", "s", "s", "g", "g", "g", "s", "s", "g", "g", "g", "s", "s", "r", "w", "w", "w", "w", "w", "w"],
    ["w", "w", "w", "w", "w", "r", "s", "s", "g", "g", "s+", "s+", "g", "g", "s", "s", "r", "w", "w", "w", "w", "w", "w", "w"],
    ["w", "w", "w", "w", "w", "w", "r", "s", "s", "g", "g", "g", "g", "s", "s", "r", "w", "w", "w", "w", "w", "w", "w", "w"],
    ["w", "w", "w", "w", "w", "w", "w", "r", "s", "s", "g", "g", "s", "s", "r", "w", "w", "w", "w", "w", "w", "w", "w", "w"],
    ["w", "w", "w", "w", "w", "w", "w", "w", "r", "s", "s", "s", "s", "r", "w", "w", "w", "w", "w", "w", "w", "w", "w", "w"],
    ["w", "w", "w", "w", "w", "w", "w", "w", "w", "r", "r", "s", "r", "w", "w", "w", "w", "w", "w", "w", "w", "w", "w", "w"],
    ["w", "w", "w", "w", "w", "w", "w", "w", "w", "w", "r", "r", "w", "w", "w", "w", "w", "w", "w", "w", "w", "w", "w", "w"]
  ]
}
